LLOLLLLLLLLLLLLLLLLLLLLLLLLLLLOLL
LLOLLLLLLLLLLLLLLLLLLLLLLLLLLLOLL
LLOLLLLLLLLLLLLLLLLLLLLLLLLLLLOLL
LLOLLLLLLLLLLLLLLLLLLLLLLLLLLLOLL
LLOLLLLLLLLLLLLLLLLLLLLLLLLLLLOLL
            YY     YYLLLLLLLLLLLL
            Y       YLLLLLLLLLLLL
            Y       YLLLLLLLLLLLL
           Y  YYYYY  YLLLLLLLLLLL
           Y         YLLLLLLLLLLL
           Y  YY YY  YLLLLLLLLLLL
          Y           YLLLLLLLLLL
          Y           YLLLLLLLLLL
          Y   YYYY    YLLLLLLLLLL
         Y             YLLLLLLLLL
         Y             YLLLLLLLLL
         Y  YYY   YYY  YLLLLLLLLL
        Y               YLLLLLLLL
        Y               YLLLLLLLL
        Y    YYYYYY     YLLLLOLLL
       Y                 YLLLLLLL
       Y                 YLLLLLLL
       Y  YYYY   YYYYY   YLLLOLLL
      Y                   YLLLLLL
      Y                   YLLOLLL
      Y                   YLLLLLL
     YO                   OYLLLLL
     YO                   OYLLLLL
     Y    YYYY     YYYY    YLLLLL
    Y                       YLLLL
    Y                       YLLLL
    Y                    F  YLLLL
    YYYYYYYXXXXXXXXXXXYYYYYYYLLLL
   YYYYYYY             YYYYYYYLLL
   YYYYYYY             YYYYYYYLLL
   YYYYYYY             YYYYYYYLLL
   YYYYYYYXXXXXXXXXXXXXYYYYYYYLLL
   YYYYYY               YYYYYYLLL
   YYYYYY               YYYYYYLLL
   YYYYYY               YYYYYYLLL
   YYYYYYXXXXXXXXXXXXXXXYYYYYYLLL
  YYYYYY                 YYYYYYLL
  YYYYYY                 YYYYYYLL
  YYYYYY                 YYYYYYLL
  YYYYYYXXXXXXXXXXXXXXXXXYYYYYYLL
  YYYYY                   YYYYYLL
  YYYYY                   YYYYYLL
  YYYYY                   YYYYYLL
  YYYYYXXXXXXXXXXXXXXXXXXXYYYYYLL
 YYYYY                     YYYYYL
 YYYYY                     YYYYYL
 YYYYY                     YYYYYL
 YYYYYXXXXXXXXXXXXXXXXXXXXXYYYYYL
 YYYY                       YYYYL
 YYYY                       YYYYL
 YYYY                       YYYYL
 YYYYXXXXXXXXXXXXXXXXXXXXXXXYYYYL 
YYYY                         YYYY
YYYY                         YYYY
YYYY                         YYYY
YYYYXXXXXXXXXXXXXXXXXXXXXXXXXYYYY
YYY                           YYY
YYY                           YYY
YYY                           YYY
YYYYYYYYYYYYYYYYYYYYYYYYYYYYYYYYY