LLLLLOLLLLLLLLLLLLLLLLLLLLLOLLLLL
LLLLLOLLLLLLLLLLLLLLLLLKLLLOLLLLL
LLLLLOLLLLLLLLLLLLLLLLLLLLLOLLLLL
LLLLLOLLLLLLLLLLLLLLLLLLLLLOLLLLL
LLLLLLLLLLLLLLLLLLLLLLLLLLLLLLLLL
          ZYYYY    YYYZLLLLLLLLLL
          Z           ZLLLLLLLLLL
          Z F         ZLLLLLLLLLL
          Z   YYYYY   ZLLLLLLLLLL
      O  Z             ZLLOLLLLLL
      O  ZF            ZLLOLLLLLL
      O  Z YYYY   YYYY ZLLOLLLLLL
      O Z             F ZLOLLLLLL
      O Z               ZLOLLLLLL
      O Z         N     ZLOLLLLLL
      OZ                 ZOLLLLLL
      OZ          F      ZOLLLLLL
      OZ     YYYYYY      ZOLLLLLL
     OZ                   ZOLLLLL
      Z                   ZLLLLLL
      Z YYYYYY     YYYYYY ZLLLLLL
     Z                F    ZLLLLL
     Z                     ZLLLLL
   O Z         N           ZLOLLL
    Z                       ZLLLL
    Z    F                  ZLLLL
  O Z       N               ZLOLL
   Z                         ZLLL
   Z                         ZLLL
   Z  YYYY      YYYY    YYYY ZLLL
  Z                           ZLL
  Z                    F      ZLL
  Z      YYYYYYY   YYYYYY     ZLL
 Z                             ZL
 Z                             ZL
 Z                           F ZL
YYYYYYXXXXXXXXXXXXXXXXXXXXXYYYYYY
YYYYYZ                     ZYYYYY
YYYYYZ    F                ZYYYYY
YYYYYZ                     ZYYYYY
CCCCCCXXXXXXXXXXXXXXXXXXXXXCCCCCC
YYYYYZ                     ZYYYYY
YYYYYZ    {                ZYYYYY
YYYYYZ                    FZYYYYY
CCCCCCXXXXXXXXXXXXXXXXXXXXXCCCCCC
YYYYYZ                     ZYYYYY
YYYYYZ                     ZYYYYY
YYYYYZ           }  F      ZYYYYY
CCCCCCXXXXXXXXXXXXXXXXXXXXXCCCCCC
YYYYZ                       ZYYYY
YYYYZ                       ZYYYY
YYYYZ     F                 ZYYYY
CCCCCXXXXXXXXXXXXXXXXXXXXXXXCCCCC
YYYYZ                       ZYYYY
YYYYZ                       ZYYYY
YYYYZ         }             ZYYYY
CCCCCXXXXXXXXXXXXXXXXXXXXXXXCCCCC
YYYYZ                       ZYYYY
YYYYZ                       ZYYYY
YYYYZ               F       ZYYYY
CCCCCXXXXXXXXXXXXXXXXXXXXXXXCCCCC 
YYYZ                         ZYYY
YYYZ                         ZYYY
YYYZ                         ZYYY
CCCCXXXXXXXXXXXXXXXXXXXXXXXXXCCCC
YYYZ                         ZYYY
YYYZ   U                     ZYYY
YYYZ                         ZYYY
YYYYYYYYYYYYYYYYYYYYYYYYYYYYYYYYY