LLLLLOLLLLLLLLLLLLLLLLLLLLLOLLLLL
LLLLLOLLLLLLLLLLLLLLLLLLLLLOLLLLL
LLLLLLLLLLLLLLLLLLLLLLLLLLLLLLLLL
LLLLLLLLLLLLLLLLLLLLLLLLLLLLLLLLL
LLLLLLLLLLLLLLLLLLLLLLLLLLLLLLLLL
          ZYYYY    YYYZLLLLLLLLLL
          Z           ZLLLLLLLLLL
          Z           ZLLLLLLLLLL
          Z   YYYYY   ZLLLLLLLLLL
         Z             ZLLLLLLLLL
         Z             ZLLLLLLLLL
         Z YYYY   YYYY ZLLLLLLLLL
        Z               ZLLLLLLLL
        Z               ZLLLLLLLL
      O Z     N         ZLOLLLLLL
       Z                 ZLLLLLLL
       Z                 ZLLLLLLL
       Z     YYYYYY      ZLLLLLLL
      Z                   ZLLLLLL
      Z                   ZLLLLLL
      Z YYYYYY     YYYYYY ZLLLLLL
     Z                     ZLLLLL
     Z                     ZLLLLL
   O Z     N               ZLOLLL
    Z                       ZLLLL
    Z                       ZLLLL
  O Z              N        ZLOLL
   Z                         ZLLL
   Z                         ZLLL
   Z  YYYY      YYYY    YYYY ZLLL
  Z                           ZLL
  Z                           ZLL
  Z      YYYYYYY   YYYYYY     ZLL
 Z                             ZL
 Z                             ZL
 Z                             ZL
YYYYYYXXXXXXXXXXXXXXXXXXXXXYYYYYY
YYYYYZ                     ZYYYYY
YYYPYZ                     ZYPYYY
YYYYYZ                     ZYYYYY
CCCCCCXXXXXXXXXXXXXXXXXXXXXCCCCCC
YYYYYZ                     ZYYYYY
YYYPYZ                     ZYPYYY
YYYYYZ                     ZYYYYY
CCCCCCXXXXXXXXXXXXXXXXXXXXXCCCCCC
YYYYYZ                     ZYYYYY
YYYPYZ                     ZYPYYY
YYYYYZ                     ZYYYYY
CCCCCCXXXXXXXXXXXXXXXXXXXXXCCCCCC
YYYYZ                       ZYYYY
YYPYZ                       ZYPYY
YYYYZ                       ZYYYY
CCCCCXXXXXXXXXXXXXXXXXXXXXXXCCCCC
YYYYZ                       ZYYYY
YYPYZ                       ZYPYY
YYYYZ                       ZYYYY
CCCCCXXXXXXXXXXXXXXXXXXXXXXXCCCCC
YYYYZ                       ZYYYY
YYPYZ                       ZYPYY
YYYYZ                       ZYYYY
CCCCCXXXXXXXXXXXXXXXXXXXXXXXCCCCC 
YYYZ                         ZYYY
YPYZ                         ZYPY
YYYZ                         ZYYY
CCCCXXXXXXXXXXXXXXXXXXXXXXXXXCCCC
YYYZ                         ZYYY
YPYZ                         ZYPY
YYYZ                         ZYYY
YYYYYYYYYYYYYYYYYYYYYYYYYYYYYYYYY