LLLLLOLLLLLLLLLLLLLLLLLLLLLOLLLLL
LLLLLOLLLLLLLLLLLLLLLLLLLLLOLLLLL
LLLLLOLLLLLLLLLLLLLLLLLLLLLOLLLLL
LLLLLOLLLLLLLLLLLLLLLLLLLLLOLLLLL
LLLLLLLLLLLLLLLLLLLLLLLLLLLLLLLLL
          ZYYYY    YYYZLLLLLLLLLL
          Z           ZLLLLLLLLLL
          Z F         ZLLLLLLLLLL
          Z   YYYYY   ZLLLLLLLLLL
      O  Z             ZLLOLLLLLL
      O  ZF            ZLLOLLLLLL
      O  Z YYYY   YYYY ZLLOLLLLLL
      O Z             F ZLOLLLLLL
      O Z               ZLOLLLLLL
      O Z     N         ZLOLLLLLL
      OZ                 ZOLLLLLL
      OZ          F      ZOLLLLLL
      OZ     YYYYYY      ZOLLLLLL
     OZ                   ZOLLLLL
      Z                   ZLLLLLL
      Z YYYYYY     YYYYYY ZLLLLLL
     Z                F    ZLLLLL
     Z                     ZLLLLL
   O Z     N               ZLOLLL
    Z                       ZLLLL
    Z    F                  ZLLLL
  O Z              N        ZLOLL
   Z                         ZLLL
   Z                         ZLLL
   Z  YYYY      YYYY    YYYY ZLLL
  Z                           ZLL
  Z                    F      ZLL
  Z      YYYYYYY   YYYYYY     ZLL
 Z                             ZL
 Z                             ZL
 Z                           F ZL
YYYYYYXXXXXXXXXXXXXXXXXXXXXYYYYYY
YYYYYZ                     ZYYYYY
YYYPYZ    F                ZYPYYY
YYYYYZ                     ZYYYYY
CCCCCCXXXXXXXXXXXXXXXXXXXXXCCCCCC
YYYYYZ                     ZYYYYY
YYYPYZ                     ZYPYYY
YYYYYZ                    FZYYYYY
CCCCCCXXXXXXXXXXXXXXXXXXXXXCCCCCC
YYYYYZ                     ZYYYYY
YYYPYZ                     ZYPYYY
YYYYYZ              F      ZYYYYY
CCCCCCXXXXXXXXXXXXXXXXXXXXXCCCCCC
YYYYZ                       ZYYYY
YYPYZ                       ZYPYY
YYYYZ     F                 ZYYYY
CCCCCXXXXXXXXXXXXXXXXXXXXXXXCCCCC
YYYYZ                       ZYYYY
YYPYZ                       ZYPYY
YYYYZ                       ZYYYY
CCCCCXXXXXXXXXXXXXXXXXXXXXXXCCCCC
YYYYZ                       ZYYYY
YYPYZ                       ZYPYY
YYYYZ               F       ZYYYY
CCCCCXXXXXXXXXXXXXXXXXXXXXXXCCCCC 
YYYZ                         ZYYY
YPYZ                         ZYPY
YYYZ                         ZYYY
CCCCXXXXXXXXXXXXXXXXXXXXXXXXXCCCC
YYYZ                         ZYYY
YPYZ                         ZYPY
YYYZ      U                  ZYYY
YYYYYYYYYYYYYYYYYYYYYYYYYYYYYYYYY