LLLLOLLLLLLLLLLLLLLLLLLLLLLOLLLLL
LLLLLLLLLLLLLLLLLLLLLLLLLLLLLLLLL
LLLLLLLLLLLLLLLLLLLLLLLLLLLLLLLLL
LLLLLLLLLLLLLLLLLLLLLLLLLLLLLLLLL 
           YYY     YYYLLLLLLLLLLL
           Y         YLLLLLLLLLLL
          Y           YLLLLLLLLLL
          Y   YYYY    YLLLLLLLLLL
         Y             YLLLLLLLLL
         Y             YLLLLLLLLL
        Y   YYY  YYY    YLLLLLLLL
        Y               YLLLLLLLL
       Y       F         YLLLLLLL
       Y     YYYYY       YLLLLLLL
      Y                   YLLLLLL
      Y                   YLLLLLL
     Y   YYYY     YYYY     YLLLLL
     Y                     YLLLLL
    Y                       YLLLL
    Y                       YLLLL
    YYYYYYYXXXXXXXXXXXYYYYYYYLLLL
   YYYYYYY             YYYYYYYLLL
   YYYYYYY             YYYYYYYLLL
   YYYYYYY             YYYYYYYLLL
   YYYYYYYXXXXXXXXXXXXXYYYYYYYLLL
   YYYYYY               YYYYYYLLL
   YYYYYY               YYYYYYLLL
   YYYYYY               YYYYYYLLL
   YYYYYYXXXXXXXXXXXXXXXYYYYYYLLL
  YYYYYY                 YYYYYYLL
  YYYYYY                 YYYYYYLL
  YYYYYY                 YYYYYYLL
  YYYYYYXXXXXXXXXXXXXXXXXYYYYYYLL
  YYYYY                   YYYYYLL
  YYYYY                   YYYYYLL
  YYYYY                   YYYYYLL
  YYYYYXXXXXXXXXXXXXXXXXXXYYYYYLL
 YYYYY                     YYYYYL
 YYYYY                     YYYYYL
 YYYYY                     YYYYYL
 YYYYYXXXXXXXXXXXXXXXXXXXXXYYYYYL
 YYYY                       YYYYL
 YYYY                       YYYYL
 YYYY                       YYYYL
 YYYYXXXXXXXXXXXXXXXXXXXXXXXYYYYL 
YYYY                         YYYY
YYYY                         YYYY
YYYY                         YYYY
YYYYXXXXXXXXXXXXXXXXXXXXXXXXXYYYY
YYY                           YYY
YYY                           YYY
YYY                           YYY
YYYYYYYYYYYYYYYYYYYYYYYYYYYYYYYYY