LOLLLLLLLLLLLLLLLLLLLLLLLLLLLLOLL
LOLLLLLLLLLLLKLLLLLLLLLLLLLLLLOLL
LLLLLLLLLLLLLLLLLLLLLLLLLLLLLLLLL
LLLLLLLLLLLLLLLLLLLLLLLLLLLLLLLLL
   YYYYY                 YYYYYLLL
LLLLLLLLLLLLLLLLLLLLLLLLLLLLLLLLL
                   LLLLLLLLLLLLLL
LLLLLLLLLLLLLLLLLLLLLLLLLLLLLLLLL
ZZZZZZZZZZ             ZZZZZZZZZZ
ZZZZZZZZZZ             ZZZZZZZZZZ
ZZZZZZZZZZ             ZZZZZZZZZZ
ZZZZZZZZZZZZ         ZZZZZZZZZZZZ
ZZZZZZZZZZZZ         ZZZZZZZZZZZZ
ZZZZZZZZZZZZ         ZZZZZZZZZZZZ
ZZZZZZZZZZZZZZXXXXXZZZZZZZZZZZZZZ
ZZZZZZZZZZZZZZXXXXXZZZZZZZZZZZZZZ
ZZZZZZZZZZ             ZZZZZZZZZZ
ZZZZZZZZZZ             ZZZZZZZZZZ
ZZZZZZZZZZZZXXXXZXXXXZZZZZZZZZZZZ
ZZZZZZZZZZZ           ZZZZZZZZZZZ
ZZZZZZZZZZ             ZZZZZZZZZZ
ZZZZZZZZZ    FFFFFF     ZZZZZZZZZ
ZZZZZZ      ZZZZZZZZ       ZZZZZZ
ZZZZZZ     ZZZZZZZZZZZ     ZZZZZZ
ZZZZZZ       ZZZZZZZ       ZZZZZZ
ZZZZZZ       ZZZZZZZ       ZZZZZZ
ZZZZZZFZZ     ZZZZZ     ZZFZZZZZZ
ZZZZZZ ZZZ             ZZZ ZZZZZZ
ZZZZZZ ZZ               ZZ ZZZZZZ
ZZZZZZ ZZ   ZZZZZZZZZ   ZZ ZZZZZZ
ZZZZZZ ZZ     ZZZZZ     ZZ ZZZZZZ
ZZZZZZFZZ     ZZZZZ     ZZFZZZZZZ
ZZZZZZ ZZZXXXXZZZZZXXXZZZZ ZZZZZZ
ZZZZZZ ZZ               ZZ ZZZZZZ
ZZZZZZ ZZ               ZZ ZZZZZZ
ZZZZZZ ZZ               ZZ ZZZZZZ
ZZZZZZFZZO      +      OZZFZZZZZZ
ZZZZZZ                     ZZZZZZ
ZZZZZZ                     ZZZZZZ
ZZZZZZ       Z  P  Z       ZZZZZZ
ZZZZZZ      ZZZZZZZZZXXX   ZZZZZZ
ZZZZZ         ZZZZZ         ZZZZZ
ZZZZZF         ZZZ         FZZZZZ
ZZZZZ          ZZZ          ZZZZZ
ZZZZZZZZZXXXXXZZZZZXXXXXZZZZZZZZZ
ZZZ            ZZZ            ZZZ
ZZZ            ZZZ            ZZZ
ZZZF           ZZZ           FZZZ
ZZZ      Z  P  ZZZ  P  Z      ZZZ
ZZZZZZXXZZZZZZZZZZZZZZZZZXXZZZZZZ
ZZZ                           ZZZ
ZZZ                           ZZZ
ZZZ                           ZZZ
ZOZ           +               ZOZ
ZZZ                           ZZZ
ZZZF                          ZZZ
ZZZ   P  Z   P    Z  P  Z     ZZZ
ZZZZZZZZZZZZZZZZZZZZZZZZZXXXXXXXZ
Z                               Z
Z                               Z
Z                               Z
Z        Z       P       Z  P   Z
ZXXXXXXXXZZZZZZZZZZZZZZZZZZZZZZZZ
Z                               Z
Z A                             Z
Z     A                         Z
Z   Z                           Z
Z   Z     Z                     Z
ZZZZZZZZZZZZZZZZZZZZZZZZXXXXXXXXZ
Z                               Z
Z                               Z
Z                               Z
Z                           Z   Z
Z         Z        P        Z F Z
ZXXXXXXXXXZZZZZZZZZZZZZZZZZZZZZZZ
Z                               Z
Z                               Z
Z                               Z
ZZZZZZZZZZZZZZZZZZZZZZXXXXXXXXXXZ
Z      Q                        Z
Z                               Z
YYYYYYYYYYYYYYYYYYYYYYYYYYYYYYYYY