LOLLLLLLLLLLLLLLLLLLLLLLLLLLLLOLL
LOLLLLLLLLLLLLLLLLLLLLLLLLLLLLOLL
LLLLLLLLLLLLLLLLLLLLLLLLLLLLLLLLL
LLLLLLLLLLLLLLLLLLLLLLLLLLLLLLLLL
   YYYYY                 YYYYYLLL
LLLLLLLLLLLLLLLLLLLLLLLLLLLLLLLLL
                   LLLLLLLLLLLLLL
LLLLLLLLLLLLLLLLLLLLLLLLLLLLLLLLL
ZZZZZZZZZZ             ZZZZZZZZZZ
ZZZZZZZZZZ             ZZZZZZZZZZ
ZZZZZZZZZZ             ZZZZZZZZZZ
ZZZZZZZZZZZZ         ZZZZZZZZZZZZ
ZZZZZZZZZZZZ         ZZZZZZZZZZZZ
ZZZZZZZZZZZZ         ZZZZZZZZZZZZ
ZZZZZZZZZZZZZZXXXXXZZZZZZZZZZZZZZ
ZZZZZZZZZZZZZZXXXXXZZZZZZZZZZZZZZ
ZZZZZZZZZZ             ZZZZZZZZZZ
ZZZZZZZZZZ             ZZZZZZZZZZ
ZZZZZZZZZZZZXXXXZXXXXZZZZZZZZZZZZ
ZZZZZZZZZZZ           ZZZZZZZZZZZ
ZZZZZZZZZZ             ZZZZZZZZZZ
ZZZZZZZZZ    FFFFFF     ZZZZZZZZZ
ZZZZZZ      ZZZZZZZZ       ZZZZZZ
ZZZZZZ     ZZZZZZZZZZZ     ZZZZZZ
ZZZZZZ       ZZZZZZZ       ZZZZZZ
ZZZZZZ       ZZZZZZZ       ZZZZZZ
ZZZZZZFZZ     ZZZZZ     ZZFZZZZZZ
ZZZZZZ ZZZ             ZZZ ZZZZZZ
ZZZZZZ ZZ               ZZ ZZZZZZ
ZZZZZZ ZZ   ZZZZZZZZZ   ZZ ZZZZZZ
ZZZZZZ ZZ     ZZZZZ     ZZ ZZZZZZ
ZZZZZZFZZ     ZZZZZ     ZZFZZZZZZ
ZZZZZZ ZZZXXXXZZZZZXXXZZZZ ZZZZZZ
ZZZZZZ ZZ               ZZ ZZZZZZ
ZZZZZZ ZZ               ZZ ZZZZZZ
ZZZZZZ ZZ               ZZ ZZZZZZ
ZZZZZZFZZO     NNN     OZZFZZZZZZ
ZZZZZZ                     ZZZZZZ
ZZZZZZ                     ZZZZZZ
ZZZZZZ       Z     Z       ZZZZZZ
ZZZZZZ      ZZZZZZZZZXXX   ZZZZZZ
ZZZZZ         ZZZZZ         ZZZZZ
ZZZZZF         ZZZ         FZZZZZ
ZZZZZ          ZZZ          ZZZZZ
ZZZZZZZZZXXXXXZZZZZXXXXXZZZZZZZZZ
ZZZ            ZZZ            ZZZ
ZZZ            ZZZ            ZZZ
ZZZF           ZZZ           FZZZ
ZZZ      Z     ZZZ     Z      ZZZ
ZZZZZZXXZZZZZZZZZZZZZZZZZXXZZZZZZ
ZZZ                           ZZZ
ZZZ                           ZZZ
ZZZ   F                       ZZZ
ZOZ           NNN             ZOZ
ZZZ                           ZZZ
ZZZF   F                      ZZZ
ZZZ      Z       Z      Z     ZZZ
ZZZZZZZZZZZZZZZZZZZZZZZZZXXXXXXXZ
Z                               Z
Z                               Z
Z                               Z
Z        Z               Z      Z
ZXXXXXXXXZZZZZZZZZZZZZZZZZZZZZZZZ
Z                               Z
Z                               Z
Z                               Z
Z   Z                           Z
Z   Z     Z                     Z
ZZZZZZZZZZZZZZZZZZZZZZZZXXXXXXXXZ
Z                               Z
Z                               Z
Z                               Z
Z                           Z   Z
Z          Z                Z F Z
ZXXXXXXXXXXZZZZZZZZZZZZZZZZZZZZZZ
Z                               Z
Z                               Z
Z                               Z
ZZZZZZZZZZZZZZZZZZZZZZXXXXXXXXXXZ
Z                               Z
Z    U                          Z
YYYYYYYYYYYYYYYYYYYYYYYYYYYYYYYYY