O                               O
                                                                  
                                 
YYYYYYYYYXXXXXXXXXXXXXXXYYYYYYYYY
YYYYYYYYLLLLLLLLLLLLLLLLLYYYYYYYY
YYYYYYYYLLLLLLLLLLLLLLLLLYYYYYYYY
YYYYYYYYLLLLLLLLLLLLLLLLLYYYYYYYY
YYYYYYYYXXXXXXXXXXXXXXXXXYYYYYYYY
YYYYYYYLLLLLLLLLLLLLLLLLLLYYYYYYY
YYYYYYYLLLLLLLLLLLLLLLLLLLYYYYYYY
YYYYYYYLLLLLLLLLLLLLLLLLLLYYYYYYY
YYYYYYYXXXXXXXXXXXXXXXXXXXYYYYYYY
YYYYYYLLLLLLLLLLLLLLLLLLLLLYYYYYY
YYYYYYLLLLLLLLLLLLLLLLLLLLLYYYYYY
YYYYYYLLLLLLLLLLLLLLLLLLLLLYYYYYY
YYYYYYXXXXXXXXXXXXXXXXXXXXXYYYYYY
YYYYYLLLLLLLLLLLLLLLLLLLLLLLYYYYY
YYYYYLLLLLLLLLLLLLLLLLLLLLLLYYYYY
YYYYYLLLLLLLLLLLLLLLLLLLLLLLYYYYY
YYYYYXXXXXXXXXXXXXXXXXXXXXXXYYYYY
YYYYLLLLLLLLLLLLLLLLLLLLLLLLLYYYY
YYYYLLLLLLLLLLLLLLLLLLLLLLLLLYYYY
YYYYLLLLLLLLLLLLLLLLLLLLLLLLLYYYY
YYYYXXXXXXXXXXXXXXXXXXXXXXXXXYYYY
YYYLLLLLLLLLLLLLLLLLLLLLLLLLLLYYY
YYYLLLLLLLLLLLLLLLLLLLLLLLLLLLYYY
YYYLLLLLLLLLLLLLLLLLLLLLLLLLLLYYY
YYYXXXXXXXXXXXXXXXXXXXXXXXXXXXYYY
YYLLLLLLLLLLLLLLLLLLLLLLLLLLLLLYY
YYLLLLLLLLLLLLLLLLLLLLLLLLLLLLLYY
YYLLLLLLLLLLLLLLLLLLLLLLLLLLLLLYY
YYXXXXXXXXXXXXXXXXXXXXXXXXXXXXXYY
YLLLLLLLLLLLLLLLLLLLLLLLLLLLLLLLY
YLLLLLLLLLLLLLLLLLLLLLLLLLLLLLLLY
YLLLLLLLLLLLLLLLLLLLLLLLLLLLLLLLY
YYYYYYYYYYYYYYYYYYYYYYYYYYYYYYYYY