O                               O
                                                                  
                                 
YYYYYYYYYYYXXXXXXXXXXXYYYYYYYYYYY
YYYYYYYYYY             YYYYYYYYYY
YYYYYYYYYY             YYYYYYYYYY
YYYYYYYYYY             YYYYYYYYYY
YYYYYYYYYYXXXXXXXXXXXXXYYYYYYYYYY
YYYYYYYYY               YYYYYYYYY
YYYYYYYYY               YYYYYYYYY
YYYYYYYYY               YYYYYYYYY
YYYYYYYYYXXXXXXXXXXXXXXXYYYYYYYYY
YYYYYYYY                 YYYYYYYY
YYYYYYYY                 YYYYYYYY
YYYYYYYY                 YYYYYYYY
YYYYYYYYXXXXXXXXXXXXXXXXXYYYYYYYY
YYYYYYY                   YYYYYYY
YYYYYYY                   YYYYYYY
YYYYYYY                   YYYYYYY
YYYYYYYXXXXXXXXXXXXXXXXXXXYYYYYYY
YYYYYY                     YYYYYY
YYYYYY                     YYYYYY
YYYYYY                     YYYYYY
YYYYYYXXXXXXXXXXXXXXXXXXXXXYYYYYY
YYYYY                       YYYYY
YYYYY                       YYYYY
YYYYY                       YYYYY
YYYYYXXXXXXXXXXXXXXXXXXXXXXXYYYYY
YYYY                         YYYY
YYYY                         YYYY
YYYY                         YYYY
YYYYXXXXXXXXXXXXXXXXXXXXXXXXXYYYY
YYY                           YYY
YYY                           YYY
YYY                           YYY
YYYYYYYYYYYYYYYYYYYYYYYYYYYYYYYYY