O                               O
                                                                  
                                 
YYYYYYYYYXXXXXXXXXXXXXXXYYYYYYYYY
YYYYYYYY                 YYYYYYYY
YYYYYYYY                 YYYYYYYY
YYYYYYYY                 YYYYYYYY
YYYYYYYYXXXXXXXXXXXXXXXXXYYYYYYYY
YYYYYYY                   YYYYYYY
YYYYYYY                   YYYYYYY
YYYYYYY                   YYYYYYY
YYYYYYYXXXXXXXXXXXXXXXXXXXYYYYYYY
YYYYYY                     YYYYYY
YYYYYY                     YYYYYY
YYYYYY                     YYYYYY
YYYYYYXXXXXXXXXXXXXXXXXXXXXYYYYYY
YYYYY                       YYYYY
YYYYY                       YYYYY
YYYYY                       YYYYY
YYYYYXXXXXXXXXXXXXXXXXXXXXXXYYYYY
YYYY                         YYYY
YYYY                         YYYY
YYYY                         YYYY
YYYYXXXXXXXXXXXXXXXXXXXXXXXXXYYYY
YYY                           YYY
YYY                           YYY
YYY                           YYY
YYYXXXXXXXXXXXXXXXXXXXXXXXXXXXYYY
YY                             YY
YY                             YY
YYYY                         YYYY
YYYYXXXXXXXXXXXXXXXXXXXXXXXXXYYYY
YYY                           YYY
YYY                           YYY
YYY                           YYY
YYYYYYYYYYYYYYYYYYYYYYYYYYYYYYYYY